GGGGGGGGGGGGGGGSSGGG
GGGGGGGGGGGGGSSSSSGG
GGGGGGGGGGGSSSSSSGGG
GGGGGGGGGGSSSSSSSGGG
GGGGGGGGSSSSSSSSGGGG
GGGGGGSSSSSSSSSGGGGG
GGGGGSSSSSSSSSSGGGGG
GGGGSSSSSSSSSSSGGGGG
GGGSSSSSSSSSSSGGGGGG
GGGGSSSSSSSSSGGGGGGG
GGGGGSSSSSSSGGGGGGGG
GGGGGGSSSSSGGGGGGGGG
GGGGGGGSSSGGGGGGGGGG
GGGGGGGGSSGGGGGGGGGG
GGGGGGGGSSGGGGGGGGGG