TTTTTTTTTTTTTT...TTT
TTTTTTTTTTTT.......T
TTTTTTTTTT......r..T
TTTTTTTT......R....T
TTTTTT....r........T
TTTT...R...........T
TTT...........r...TT
TT.....r..........TT
T...R.........R..TTT
TT.......r.......TTT
TTT............TTTTT
TTTT...R......TTTTTT
TTTTTT......TTTTTTTT
TTTTTTTT..TTTTTTTTTT
TTTTTTTT..TTTTTTTTTT